10 10
7 1 2 3 5 0 6 1 4 2
1 2 3 1 4 0 6 1 2 3
1 2 1 0 6 1 4 0 2 3
1 0 0 2 1 0 2 1 4 2
1 2 1 4 0 2 1 4 4 2
3 1 4 4 2 1 0 6 1 2
1 0 4 2 1 2 3 1 2 3
1 2 3 1 4 0 2 1 0 2
1 4 2 1 4 2 3 1 0 2
5 4 4 0 2 1 4 2 5 2
