7 8
4 4 4 2 1 2 5 2
4 4 2 1 0 0 4 2
5 4 0 6 1 0 4 6
5 4 0 6 5 0 0 4
4 0 0 4 6 1 0 2
3 1 0 4 0 0 2 3
1 4 2 5 0 2 3 3
